NO ./path_to_the_north_texture

SO ./path_to_the_south_texture

WE ./path_to_the_west_texture

EA ./path_to_the_east_texture

F 223, 155, 22

C 225,30, 12


        111111111111111111111111111
        1000000000011000000000001 
        1011000001110000000000001  
        1001000000000000000000001  
111111111011000001110000000000001  
100000000110000011101111111111111   
11110111111111011100000011111   
11110111111111011101010010001      
11000111101010111000000100011      
10000000000000000110010001011      
10110111000000001101010010001      
11S01111110111111111100111111      
11010111 1110101 101111010001      
11111111 1111111 111111111111      